#A#####
#     #
# ### #
# ### #
##### #
#     #
# ### #
#     #
#####B#