####A###
#      #
# ## # #
# #  ###
#      #
# # ## #
#B##   #
########
