############A############
#   #                   #
# ### ################# #
# ###                   #
# ### ################# #
# ###                   #
# ################# # # #
#                   #   #
# ################# # # #
#                   # # #
# ################# # # #
#                 #     #
# ############# # # # # #
#             #       # #
# ######### # ######### #
#                 #   # #
# ############# # # # # #
# #               #     #
# # ############### # # #
# #             #     # #
# # ########### # # ### #
# #             #     # #
# # ############### # # #
#                   #   #
# ################# # # #
#                 #     #
# ######### # # ### # # #
#           # #     #   #
# ######### # ### # # # #
#         #       #   # #
# ####### ########### # #
#       #     #       # #
# ##### ##### # ##### # #
#   B             #     #
#########################
