################A##################
#     #               #           #
# ### ######### ##### ### ####### #
#   #       #           #       # #
# ### ### ########### ### ##### # #
#   #   #   #       # #   #     # #
# ### ##### ### ### # ### ##### # #
#     #       #   # # #         # #
####### ### ### ### # ######### # #
#   #     #   #       #   #     # #
# # ### ### ### ##### ### ##### # #
# # #   #   #     #     #     #   #
# # ### ##### ##### ### ### #######
# #         #   #     #     #     #
# ######### ### ### ##### ##### # #
#         #   #   #   #     #     #
# ####### ######### ### ##### ### #
#       #       #   #   #     #   #
# ### ### ### ### ##### ##### ### #
#   #     #   #     #   #         #
####### ##### ### ### ### ### #####
#   #         #     #   #   #     #
# ### ### ######### ##### ### ### #
#     #     #       #   #     #   #
##### ##### ### ### ### ####### ###
#       #   # #   #       #       #
# ####### ### ### ######### ### ###
#     #     #     #     #     #   #
### ### ### ##### ### ### ### # # #
#   #       #           #       # #
# ### ####### ######### ####### ###
#   #                 #           #
### ######### ### ### #############
#       #     #   #   #           #
# ##### # ### ### ### #############
#       # #     #     #           #
# ####### ####### ### #############
#       #       #   #             #
# ##### ######### ### ########### #
#   #       #     #   #         # #
# ### ##### ### ##### ######### # #
#           #     #               #
#############B#####################
